{
  "0": 0,
  "1": 0,
  "2": 0,
  "3": 0,
  "4": 0,
  "5": 0,
  "6": 0,
  "7": 0,
  "8": 0,
  "9": 0,
  "10": 1,
  "11": 1,
  "12": 1,
  "13": 1,
  "14": 1,
  "15": 2,
  "16": 2,
  "17": 2,
  "18": 2,
  "19": 2,
  "20": 3,
  "21": 3,
  "22": 3,
  "23": 3,
  "24": 3,
  "25": 4,
  "26": 4,
  "27": 4,
  "28": 4,
  "29": 4,
  "30": 5,
  "31": 5,
  "32": 5,
  "33": 5,
  "34": 5,
  "35": 6,
  "36": 6,
  "37": 6
}